###################
#           +    +#
# @+*+++   +++*+@ #
#      +   +      #
#    +++++ +++    #
#    + +   +      #
#      +   +      #
#      +++++++*@+ #
#                 #
###################