###################
#                 #
# @+*+++++++++*+@ #
#      +   +      #
#     +++ +++     #
#      +   +      #
#      +   +      #
# @+*+++++++++*+@ #
#                 #
###################